6
4
+-+-+-+-+-+-+
| |   |     |
+ + + + + + +
|   | | | | |
+-+-+ +-+ + +
|   |   | | |
+ + +-+ + + +
| |       | |
+-+-+-+-+-+-+